111111111111111111
100010001000000001
100000001000C00001
100111001111110001
1001P00010C0000001
100111111000110001
100000000000100E01
111111111111111111