1111111111111111111111111
1000000000010000000000001
1011111111010111111111101
1000001000010000000000101
1111101111111111111011101
1000100000001000001000001
1010111111111011111011101
1000100000000010000000101
1111111011111110111111101
1000001010000000001000001
1011111010111111111011101
1000000010000000000000101
1011111111111111111111101
1000000000000001000000001
1111111111111111111111111