11111111111111111111
10000001000000000001
1P000010000111000001
10000100001001000001
10001111000010000001
10000001000100000001
10000001001111000001
10000000000000000001
10000000000000000001
10000000C000000000E1
11111111111111111111